11111111111
1EC000C0C01
111111111P1
11111111111

lab/while(1)/continue.ber

Once started, it is impossible finishing this dungeon...
