11111
1E101
10111
1C1P1
10001
11111
