1111111111
1P0C0E00011
1111111111
