111111111111111
100000P1C0000E1
111111111111111
