++++++++++++++++++++
++E000000C0000C+++++
++++C+0+000C000++0++
+++0C0++++++P000+00+
++++0+++++++0000+C01
+++++C00000000100101
+++0010000000000C001
++++1010000000C000++
+++++00000000000100+
+-$-++00010+++++++++
+$--$#+111++000000@1
+-++-++0000000000001
+-++++00001001000001
+-----00000$$0000001
+-$$$-10000$$0000001
+-$$$-00000000100001
+-------000000000001
+-----1---1000000001
+-----00-00000000101
11111111111111111111
