1111111111
1CPE000001
1000000001
10000000B1
1111111111
