1111111111
1CPE000001
1000000001
1000000001
1111111111
1b00000001
1111111111
