1111111111
1CPE000001
1000000001
1000000001
1000000001
1000000001
1000000001
1000000001
1000000001
1000000001
1000000001
1000000001
1111111111
1b00000001
10000000B1
1111111111
