11111
1PCE1
11111

NONE

BRN=1.0f
