111111
1E1PC1
10QQ01
10QQ01
10QQ01
10QQ01
10QQ01
10QQ01
10QQ01
10QQ01
100001
111111
