1111111111
1PE1!11111
1C$0!100C1
1#@$?!-111
1111111111
