11111
1EPC1
11111

lab/invalid/nv
