111111111111111
1P00000000000C1
1E0000000000001
100000000000001
100000000000001
100000000000001
1000000H0000001
100000000000001
100000000000001
100000000000001
100000000000001
100000000000001
1000000000H0001
100000000000001
100H00000000001
100000000000001
1000000000H0001
100000000000001
10H000000000001
1000000H0000001
100000000000001
100H00H000H0001
111111111111111
