1111111111111111111111111
1P00000000000000010000001
1EC0000000000000010000001
1000000000000000010h00001
1000000000000000011111111
1000000000000000010h00001
1000000000000000010000001
1000000000000000011111111
1000000000000000010000001
1000000000000000010h00001
1000000000000000010000001
1000000000000000011111111
1000000000000000010h00001
1000000000000000010000001
1000000000000000010000001
1111111111111111111111111
1000000000000000000000001
1111111111111111111111111
1000000000000000000000001
1111111111111111111111111
100000000000000Q000000001
1111111111111111111111111
1000000q000000000000000q1
1111111111111111111111111
