11111111111
1PC000C0C01
111111111E1
11111111111

while(1)/if.ber
while(1)/else.ber

You won't win...
