1111111111111111111111111111111111111111111111111111111111111111111111111111111111111111111111111111
1000000000000000000P00000000000000000000000000000000000C000000000000001000000CE000000000000000000001
1000000000000000000000000000000000000000000000000000000000000000000000000000000000000000000000010001
1000000000000000000000000000000000000000000000000000000000000000C000000000000000000000000C0000000001
10000000000000000000000010000000C0000000100000000C00000000000000000000000000C00000000000010000000001
10000000000000000000000000000000000000000000000000000000C0000000000000000000000000000000000000000001
1000000000000000000000000000000000C000000000C0000000000000000000000000000000000000000000000000000001
1000000000000000000000000000000000000000000000000000000000000000000000000000000000000000000000000001
1000000000001000000000000000000000000000000000000000000000000000000000000000000000000000000000000001
100000000000000000000000000000000000000000000000000000000000000000000000000C000000000000000000000001
1000C00000001000000000000000000000000000000000000000000000000000000000000000000000000000000000000001
1000000000000000000000000000001000000001000000000000000000000000000000000000000000000000000000000001
1000000000000000000000000000000000000000000000000000000000000000000010000000000000000000000000000001
1000000000100000000000000000000000000000000000000000000000000000000000000000000C00000000000000000001
100000000000000000000000001000000000000000000000000000000000C000000000000000000000000000000000000001
10000000000000000100000000000000000C0010000000C00000000000000000000000000000000000000000000000000001
100000000100000C00000C000000000000010000000000000000000000000000000000000000000000000000000000000001
1000000000000000000000000000000000000000000000000000000000000000000000000000000000000000000000000001
1000000000000000000000000000000000000000000000000000000000000000000000000000000000000000000000000001
100000000000000000000000000000000000000000000000000C000000000000000000000000000000000000000000000001
1000000000000000000000000010000000000000000000000000000000000000000000000000000000000000000000000001
1000000000000000000000000000000000000000000000100000000010000000000000000000000000000000000000000001
1000000000000000000000C0000000000000000000000000000000000000000000000CC00000000000000000000100000001
10000000000000000000000C0100000000000000000000001000000000000000000000000000000000000000000C00000001
1000000000000000000000000000000000000000000000000000000000000000000000000000000000000000000000000001
1000000000000000000000000000000000000000000000000000000000000000000000000000000000000000000000000001
1000000000000000000000000000000000000000000000000000000000000000000000000000000000000000000000000C01
1000000000000000000000000000000000000000000000000000000000000010C00010000000000010000000000000000001
1000000000000000000001000000000000000000000000000000000000010000000000000000000000000000000000000001
1000C0000C000000000C00000000000000000000000000000000000000000000000000000000000000000000000000000001
10000000000000C0000000000000000000000000000001000000000000000000000000000000000000000000000000000001
1000000000000000000000000000000000000000000000000000000000000000000000000000000000000000000000000001
100000000000000000000000000100000000000000000C00000000000000000000C000000000000000000000000000000001
1000000000000000000000000000000000000000000000000000000000000000000000000000000000000000000000000001
1000000000000100000000000000000000000000000000000000000000000000000000000000000000000000000000000001
10000000000000000000000000000000000000000000000000000000000000000000000000000000000000000000C0000001
10000C0000000000000000000000000000C00000000000000000000000000000000000000001000010000000000000000001
1000000000000000000000000000000000000000000000000000000000000000000000000000000000000000000000000001
10000000C0000000000000000000000000000000000000000000000000000000000000000000000000000000000000000001
1000000000000000000000000000000000000000000000000100000000000000000000000000000000000000000000000001
1000000000000000000000000000000000000000000000000000000000000000000000000000000000000000000000000001
1000000000000000000010C00000000000000000000000000000000000000000000C00000000000000000000000000000001
1000000000000000000000000000000000000000000000000000000000000000000000000000000000000000000000000001
100000000000000000000000000000000000000000000000000C0000000000000000000000000C0000000010000000000001
1000000000000000000000000000000000000100000000000000000000000000000000000000000000000000000000000001
10000001000000000000000000000000000000000000000000000000000000000000000000000000010000000000C0000001
1000000000000000000000000000000000000000000000000000000000000000010000000000000000000000000000000001
100000000000000000000000000000000000000000000C000000000000000000000000000000000010000000000000000001
1000000000000000000000000000000000000000000000000000000000000000000000000000000000000000000001000001
1000000000000000000000000000000001000000000000000000000000000000000000000000000000000000000000000001
100000000000000C0000000100000C0000000000000000000000000000000000000000000000000000000000000000000001
1000000000000000000000000000000000000000000000000000000000000000000000000000C00000000000000000000C01
100000000000000000000000000000000000000000000000000000000000000000000000000000C000000000000000000001
10000000000000100000000000000000000000000C0000000000000000000000000000000000000000000000000000000001
1000010000000000000000000000000000000000000C0001000001000000000000000000000000000000000000C000000001
1000000000000000C000000000000000000000000000000000000000000000000000000000000000C0000000000000000001
1000000000000000000000000000000000000000000001000000000000000000000000000000000000000000000000000001
100000000000000000000000000000000000000000C000000000000000000000000000000000000000000000000000000C01
1000000000000000000000000000000000000000000000000000000000000000000000000000000000000000000000000001
10C0000000000000000000000000000000000000000000000000000000000000000000000000000000000000000100000001
1000000000000000000000000000000C00000000000000000000000000000100000000000000000000000000000000000001
1000000000000000000000000000000000000000000000000000000000000000000000000100000000000000000000000001
1000000000000000000000000000000000000000000000000000000000000000000000000000000000000000000001000001
1000000000000000000000000000000000000000000000000000000000000000000000000010000000000000000000000001
10000000000C00000000000000000000000000000000000000000000000000000000000C0000000000000000000000000001
1000000000000000000000000000000000000000000000000000000000000000000000000000000000000000001000000001
1000000000000000000000000000000000000000000000000000000000000000000010000000000000000000000000000001
100000000000000000000000000000000000000C000000000000000000000000000000000000000000000000000010000001
10000000000000000000000C0000000000000000000000000000000000000000000000000000000000000000000000000001
1000000000000000000000000000000000000000000000000000000000000000000000000000000000000000000100000001
1000000000000000000000000000000000000000000000000000000000000000000000000000000000000000000000000011
1000000000000000010C00001000010000000001000000000000000000000000000000000000000000C00100000000000001
10000000C0000000000000000000000000000000000000000000000000000100000000000000000000000000000000000101
1000000000000000000000000000000000000000000000000000000000000000000000000000000000000000000000000001
1000000000000001100001000000000000000000000000000000000000000000000000000000000000000000000000000001
1000000000000000000000000000000000001000000000000000000000000000000000000000000000000000000000000001
1000C0000000000000C000000000000000000000000000000000000000000000000000000000000000000C00000000000001
1C000000000000000000000000000000000000000000000000000000000000000000000000000000000000000000C0000001
1000C00000000010000000000010000000000000000000000000000000000000000000000000000000000000000000000001
1000000000000000000000000000000000000000000000100000000000000000000000000000000000000000000000000001
110C000000010000000000000000000000000000000000000000000000000000000000000000000000000000000000000001
1000000000000000000000000000000000000100000000000000000000000000000000000000000000000000000000000001
100000000000000000000000000000000000000000000000000000000000000000C000000000000000000000100000000001
10000000000000000000000000000000000000000000000000000000000000000000000C0000000000000000000000000001
1000000000000000000000000000000000000000000000000000000000000000000000100000000000000000000000000001
100000000000000000000000000010000000000000000000000C000000000000C00000000000000000000000000000000001
1000000000000000000000000000000000000000000000000000000000000000000000000C00000000000000000000000001
1000000C000000000000000000000000010C0000000000000000100000000000000000000000001000000000000000000001
10000000000000000000000000C000000000000000000000000000C000000000000000000000000000000100000000000001
1000000000100000000000000000000000000000000001000000000000000000000000000000000000000000000000000001
10000000000000000000000000000000000000000000000000000000000000C0000000000000010000000000000000000001
1000000000000000000000000000000000000000000000000000000000000000000000000000000000100000000000000001
1000000001000000000000000000000000000000000000000000010000000000000010000000000000000000000000000001
10C00000000000C0000100000000000000000000000000000000000000000000000000000000000000000000000000000001
100000100000000000000000000000C000000000000000000000000000000000000000000000000000000000000000000001
10000000000000000000000000000000000000000000000C0000000000000000000C000000000000000000000000000000C1
100000000C000000000000000000000010000000000000000000000000000000000000000000000000000000000000000001
100000000000C0000000000000C0000010000000000C0000000000000000000000000000000000000000000000C000000001
100000000C000000000C000000000C00000000000000000000000000000000000000000000000C0000000000000000010001
1111111111111111111111111111111111111111111111111111111111111111111111111111111111111111111111111111
