111111111111111111111111111111111111111111
1EP0CC1C1CCCC1101C000C000100C01C11C0100CC1
110010000C000C011C1C00C000CC000000C000C101
1000001CC100000000C11C001CC00000000101CCC1
10101C0C0CC0C00CC100000C000CC0000C1000C0C1
11C00C1C1C0CC00101000000000C000010100C0C01
1CC0CC010000C10C10C10CCC0C00CC0000001010C1
1C00CC0CCCCCC00000C100100CC00CC0000000C011
1100C0C0C1C0C0C0C101010C00001C100C01CCCC11
111C1C0C000C01C00C0CC000C0C00CC01C0CC000C1
1CC000C00000000CC0C10CC010CC000CC100C00101
10CC110CC00001C01100100CC001C000C00C00C001
1C10C00C00C0000C1CCC0C00010001C00C11C00001
1C0C00000100C0C000C0C0000000CC0C1001100C11
10000C11000000CC00010C0000100010001C0CC001
10000000C10C001000C10000C10001C00CC0000C01
11100010C00C0010000C00C001CC10101000000001
1C000C000CC00000C1CC01C0C000000C10C1000001
10C0001CC00100CC10C00101C0C0000000000C0011
100000C01110CC0001000C0001C100C10010C000C1
1000010010101C0111000CC100000C000C0CC0C0C1
100CC00C010C010CC01CCC1C100001101000010011
1111CCC0C000CCC000C00C0C01000001C1000C1011
1C0010001CC0001C0CC000C010001001C0101C0C01
100CC10C00000000CC0C0C1001C010000CC0010C01
11000010100000C00101CC000001101100100000C1
110C0C0C000100C0000000C10001CC0C1010000101
101001CC100CC001000C10C11C000C11CC000C00C1
1C0010010C00C0C00101110CCC0C01000C00001C01
10010CCC0C1001110100CCCC00C1001C0CC0C1C001
10C0C01CC1100CC10000000C0C01000C00C00CC001
1C0C0C01CC00C00C00100000CC1C01CC1000CC0001
100C00CCC000C0000000000C00C000CC1000CC00C1
1011C0CC00C011C0C00C1000010C100C1011101CC1
100000C0C0CC0CC01000010010001011C1C0C01001
10CC00CC0011000100000CC01C10C001001C0C0001
10100CC0C00000C000C1C1C0CC0C00001000000C01
1CC11C0100C1CC00C0001000CCC00100C000000CC1
1000CC000101000000CCC1C0C0101CCC0CC11C0001
1010110CC0000C011C0CCCC00CC000001010100001
11001C0000C100C100CCC000C001100000001000C1
111111111111111111111111111111111111111111
