1111111111
1C0E000P01
1111111111

