1111111111
1P000000E1
100000C001
1001C01011
1C10000101
1111111111
