1111111111
1P000000E1
100000C001
1001C00001
1C10000001
1111111111
