1111111111
1EPC??!111
1111111111
