1111111111
1EPC??!111
1----??--1
10000?!?01
1111111111
