1111111111
1P$#@EC0-+
++++++++++
