++++++++++++++++++++++++++++++
+00E0#001P000000100-+++1C000-+
+0C000C010C0000000---++1$----+
+000-0001000000010$--+$11111-+
+00--00010C000001----+-1000--+
+000---0100000001-$----10C0--+
+00000001000C0C01----@--000--+
+0C-00C0100000001-$----10C00-+
+0----001$0000001+-----1--00-+
+1-1111111111111111111111111!+
+------+$--000-+C00000-$+0000+
+-$--$-+----00-0000000--+0000+
+--00--+-$-$0$-+++++++0-+0C0$+
+-$--$-+-0C0C0C+00000000+0000+
+0-----+C000000+00000000+0000+
+0++++++++++++++0++++++++0++++
+0000000000000000000000000000+
+0000000000000000000000000000+
+1111111111110111111111111111+
+00000C0000000000000C0000000$+
+$--0-00000000000000000000000+
+1-1-111111111111111111111111+
+00100001$-000000100000000000+
+00100001---01000100C0C000100+
+0010000100-010000000000C0100+
+0010000111111111100000000100+
+0010111100--0000111111111100+
+001000100$--1-$-100000000100+
+C01000000--0100--00000000000+
++++++++++++++++++++++++++++++

Miniventure/duo1.ber
