++++++++++++++++++++++++++++++
+Cq00000000000$C000000000000$+
+0111111111111!!1111111111110+
+01E0000000000000000000000@10+
+0100000000000000000000000010+
+0100C000$00$0000$00$000$0010+
+0100000000000000000000000010+
+010000C00000000000000$000010+
+0100000000000000000000000010+
+0100C000C0000000000$000C0010+
+0100000000000000000000000010+
+0100000000$000000C0000000010+
+0100C000000------000000C0010+
+01000000000------00000000010+
+C?000000000--Qb--000000000?$+
+$?000000000--BH--000000000?C+
+01000000000------00000000010+
+0100C000000------000000C0010+
+0100000000C000000$0000000010+
+0100000000000000000000000010+
+0100C000$0000000000C000C0010+
+0100000000000000000000000010+
+010000$00000000000000C000010+
+0100000000000000000000000010+
+0100$000$00$0000$00$000C0010+
+0100000000000000000000000010+
+01#0000000000000000000000P10+
+0111111111111!!1111111111110+
+$000000000000C$00000000000qC+
++++++++++++++++++++++++++++++

Miniventure/duo13.ber

THEME=0.2f
BRN=0.8f
PAINT=TRUE
