111111111111111111111111111111
100E?#?0+0000000+00-++++P000-1
10C00?C0+0C0000000---+++$----1
1000-000+0000000+0$--+$+++++-1
100--000+0C00000+----+-+++0--1
1000---0+000000++-$----+0+0--1
1000000---00C++++-------000--1
10C-00C0+-000000+-$--+-+0C00-1
10----00+---0000++--+++++-00-1
1+$+++++++++++++++++++++++++?1
100000000000+-----------+00001
100000000000+$---+---$--+0++01
1++++++00000++++++------+++001
1+++++000000++0++++++---++0001
1++++0000000++C0+00000--+++001
1++++$0+++000000+00000--+++001
1+@+++++++000000000$000-++++01
1+C00000+0000000000-000-++0001
1+000C00+0000000000--00-+00001
1+000000000-0000000--000+0++01
100000000----000000+-0C0+0++01
100--------+---0000+--00+00+01
1000++++++++$+++++++----+C0001
10000?000+++++--+-+-+++-++0001
10+++++00+-+-+--++++++++++0+01
100+C0+00+++++++++++----++0+-1
100+00+0000000000$++++++++---1
10-+000000$00$0000000000+--001
1-$+00000000000000000000?0-001
111111111111111111111111111111

Miniventure/duo2.ber
