111111111111111111111111111111
1P--?!?!?!!??!?C0?011111111111
111-11111111111011?0111111C111
11!-11111111111?11?!1111110111
11!111111111111?11111111110111
11-111111111111111111111110111
11-111111111111111111111100111
11-111111111111111111110001111
10C111111111111111111000111111
1!1111111111110000000011111111
1!1111110000000000000000001111
1?11100C100000b000000000011111
1?00Q0011100000000000000111111
1!1100000011111000000000000001
1?000000000000000000000000+011
1!1111110000000000000011100011
1?1111111111111111100000110001
1??!!??!!??!!??!!0E11100001001
1111111111110011111+0011+11001
1111111111000+C111111000000001
111111111000000000000000001111
111111111111000000000000001111
11111C000000000000000011111111
111111100000000001100000001111
11---1111111111111111100000111
11-1!1111111111111111111C11111
11-1!1111111111111111111111#11
1$$111111111111111111111111$11
1@$!?!?!?!?!?!?!?!?!?!??!!?$11
111111111111111111111111111111

NONE

BRN=1.0f
THEME=0.4f
PAINT=FALSE
