111111111111111111111111111111
1000P0000K00000E000000K0000001
100000000000000000000000000001
100111111111111111111111111001
100100000000000000000000001001
1K0100000000000000000000001001
100100111111111111111111001001
1001001$00010000001000$1001001
10010010Q001000000100Q01001001
100100100001000000100001001001
100100100001000000100001001001
10010010000!000000!00001001001
10010011?111111111111?11001001
100100100001000000100001001001
10010010000!00@#00!00001001001
10010010000!000000!00001001001
10010010000100SS00100001001001
10010011?111111111111?11001001
1K010010000!000000!000010010K1
100100100001000000100001001001
100100100001000000100001001001
10010010Q001000000100Q01001001
1001001$00010000001000$1001001
100100111111111111111111001001
100100000000000000000000001001
1001000000000000000000000B1001
100111111111111111111111111001
100000000000000000000000000001
1C0000000000K00000000000000001
111111111111111111111111111111

NONE

PAINT=TRUE
