111111111111111111111111111111
100000000000000000000000000001
100!?!?0?0000!?!00?00?0!00?001
1000!0!0!0000000?0!?0!0?0!0001
1000?000?!?000!?!0?0??0!?00001
1000!000!00!0!00?0!00!0?0!0001
1000?!00?00?0?!?!0?00?0!00?001
100000000000000000000000000001
1000++0++000000000000++0++0001
100+@$+$#+0000000000+EC+CP+001
100+$$$$$+0000000000+CCCCC+001
100+$$$$$+0000000000+CCCCC+001
1000+$$$+000000000000+CCC+0001
10000+$+00000000000000+C+00001
100000+0000000000000000+000001
100000000000000000000000000001
100000000000000000000000000001
100000000000000000000000000001
100000000000000000000000000001
1000?0000?0!?!?!?!0?00000?0001
1000!0000!0?00000?0!00000!0001
1000?0000?0!00000!0?00000?0001
1000!0000!0?0!0!0?0!00000!0001
10000?!?!?0!00000!0?00000?0001
100000000!0?0!0!0?0!00000!0001
100000000?0!0?!?0!0?00000?0001
100000000!0?00000?0!00000!0001
1000!?!?!?0!?!?!?!0?!?!?!?0001
100000000000000000000000000001
111111111111111111111111111111

NONE

PAINT=FALSE
THEME=1.0f
BRN=1.0f
