++++++++++++++++++++++++++++++
+1111111111111111111111111111+
+10000000000000000000000000@1+
+10$000000000000000000$000001+
+100000000000000+1111!1111+01+
+100000000000000+1-------1+01+
+100000000000000+1--C-C--1+01+
+100000000000000+1-------1+01+
+100000000000000+111111111+01+
+1000000000000000000000000$01+
+1000000000000000000000000$01+
++++++++?++++++++111111111++1+
+1--------------+1-------1+-1+
+1---$---$--C---??---E---1+-1+
+1--------------+1-------1+-1+
++++++++!++++++++111111111++1+
+1000000000000000000000000001+
+1000000000000000000000000001+
+1000000000000000000000000001+
+100000000000000+1111?1111+01+
+100000000000000+1-------1+$1+
+100000000000000+1--C#$--1+01+
+100000000000000+111111111+01+
+1000000000000000000000000001+
+1000000000000000000000000001+
+1000000000000000000000000001+
+1000000000000000000000000001+
+1P00000000000000000000000001+
+1111111111111111111111111111+
++++++++++++++++++++++++++++++
