++++++++++++++++++++++++++++++
+11-11111-11111111111111----1+
+---------0000000000000000-@1+
+--$--0--0000000000000$0000--+
+1---000-0000000+1111!1111+--+
+--0000000000000+1-------1+-1+
+1-0000000000000+1--C-C--1+-1+
+1--000000000000+1-------1+01+
+100000000000000+111111111+01+
+1000000000000000000000000$01+
+1000000000000000000000000$01+
++++++++?++++++++111111111++++
+1--------------+1-------1+-1+
+1---$---$--C---??---E---1+-1+
+1--------------+1-------1+-1+
++++++++!++++++++111111111++++
+10-0000000000000000000000001+
+10--000000000000000000000001+
+1---000000000000000000000001+
+-----0000000000+1111?1111+01+
+-00--0000000000+1-------1+$1+
+-00--0000000000+1--C#$--1+01+
+10---0000000000+111111111+01+
+10---00000000000000000000001+
+----000000000000000000000001+
+1----00000000000000000000001+
+1-----0000000000000000000001+
+1P-------0000000000000000001+
+1111-1--11111111111111111111+
++++++++++++++++++++++++++++++
