++++++++++++++++++++++++++++++
++++++++++++++++++++-@++++++++
++--------------+----+------++
++--------------?----+------++
++++++++++++++++?++++!+++++-++
++--------------!+-----+??!-++
+++++++++!++++++++---K---++-++
++------------+??!-------++-++
++--------------+++++++++++-++
++-------------------+$-----++
++-------------------+$-----++
++++!+++++!+++++++++++?+++++++
++++?+++++0++++++++-----++++++
++!!$++++Q00Q+++++++-++-++++++
+--+++++++++++++++++-+?-++++++
+---++++++++++++++++!+-+++++++
+-------------?-$----+-----$++
+-------------++++++++++!+++++
++--------------+---C-------++
++--------------+++++++++++-++
++--------------!-----------++
++--------------++-------++C++
+++++++++++++++++++!++++++++++
++++++++111++++111+!++111+++++
+---------------C-----------E+
+--------C------K------C-----+
+--------K------C------K-----+
+P-------C-------------C----#+
++++++++111++++111++++111+++++
++++++++++++++++++++++++++++++

Miniventure/duo8.ber

BRN=1.0f
