++++++++++++++++++++++++++++++
+q000000000000qq000000000000q+
+0111111111111111111111111110+
+0111111111111111111111111110+
+0111111111111111111111111110+
+011111#111100000000000111110+
+011111P110000000000000111110+
+0111E@00000000000000000C1110+
+0111110000000000000000111110+
+0111110000000000000000111110+
+01111000000000000000000$1110+
+0111100000C+C++C+$0000111110+
+0111000000++++++++0000111110+
+0111000000$+Q00Q+C00000C1110+
+q111000000++0000++000011111q+
+q111000000++0000++000011111q+
+0111000000$+Q00Q+C00000$1110+
+0111000000++++++++0000111110+
+0111000000C+$++$+$0000111110+
+01110000000000000000000C1110+
+0111000000000000000000111110+
+0111000000000000000000111110+
+01110000000000000000000$1110+
+0111110110110110110110111110+
+011111$11C11$11C11$11C111110+
+0111111111111111111111111110+
+0111111111111111111111111110+
+0111111111111111111111111110+
+q000000000000qq000000000000q+
++++++++++++++++++++++++++++++

Miniventure/duo9.ber
