++++++++++++++++++++++++++++++
+H00000000000000000000000000q+
+0111111111111111111111111110+
+01h0111111111111111111110h10+
+0100111111111111111111110010+
+011111#111100110000000111110+
+011111P110000110000000111110+
+0111E@00000001100000000C1110+
+0111110000000!!0000000111110+
+0111110000000++0000000111110+
+0111100000000++00000000$1110+
+0111100000C+C++C+$0000111110+
+0111000000++++++++0000111110+
+0111000000$+Q00Q+C00000C1110+
+0111111!++++0000++++!1111110+
+0111111!++++0000++++!1111110+
+0111000000$+Q00Q+C00000$1110+
+0111000000++++++++0000111110+
+0111000000C+$++$+$0000111110+
+0111000000000++00000000C1110+
+0111000000000++0000000111110+
+0111000000000!!0000000111110+
+01110000000001100000000$1110+
+0111110110110110110110111110+
+011111$11C11$11C11$11C111110+
+0100111111111111111111110010+
+01h0111111111111111111110h10+
+0111111111111111111111111110+
+q00000000000000000000000000H+
++++++++++++++++++++++++++++++

NONE

PAINT=FALSE
THEME=0.4f
