111111111111111111111111111111
100E01001P00000C100000011C0001
1000000000C0000000010000000001
11000C00000000C00C00000100C001
1000000010C001000001C00000C0C1
100000000000C0C000000000010001
100000C000C0001000010000000001
1000000001000000C0000000010001
10C0010000000000000C0000000011
1C000C00C00C000000000000000C01
10000C01000000C000011000000001
10000000C000000000CC000C000001
100000000100000000101000000101
100CCC000CC011000001C0C00C0001
101100101C1000100000000000C001
10101000000000C100000C00010011
110000C00CC0001000010110001001
100000000000001000001000000001
100000000000000000CCC0000C1101
100000C000CC001000011000000001
1C00000C000000C000000C00C000C1
100010000000000000000000000011
100001C0000000C000C01C00101001
10C0000000C001000000C0C0C00001
100CC00C000C000000000000010001
1001000000000001C0100000010001
100000C0000000010C000000000101
10C000000C00000000100000010001
1000001000000000000100000C00C1
111111111111111111111111111111
