11111
1C001
11101
1P101
10001
11011
10001
10001
10001
10001
10001
10001
10001
10001
10001
10001
10001
10001
10001
11011
11011
11011
11011
110E1
11111

666_TORTURE/torture.ber
666_TORTURE/torture1.ber
666_TORTURE/torture2.ber
666_TORTURE/torture3.ber
