11111111111111111111
10001000100000000001
10101010101111111101
10101010101000000001
10101010101011111111
1C100010001000000001
11111111111111111101
11111111111111111101
100010001P0000000001
10101010111111111101
10101010100000000001
10101010101111111111
10101010100000000001
10101010111111111101
1E100010000000000001
11111111111111111111

666_TORTURE/torture.ber
666_TORTURE/torture1.ber
