111111111111111
1E00C0P10000001
111111111111111
