11111
10001
10P01
1C0E1
11111

666_TORTURE/torture1.ber
666_TORTURE/torture.ber
666_TORTURE/torture2.ber
