11111111111111111111111
1C000000000000100000001
1000000000000000000C001
11011100C0111100C000001
1E000000001111000001001
111111110C011100P000001
10000000000001000000001
10C00000000001000000001
1101110010111100000C001
10000000000C00000000001
11111111111111111111111

Multiverse/earth.ber

MAP SOURCE : https://github.com/S-LucasSerrano/so_long/blob/main/map_files/map_6.ber
I replaced enemies by coins or walls
