11111111111111111111
1P01001C100000C100E1
10010000000001111101
1001001C101001000001
100000101C1001000001
10000C11111001010001
1111001C0000C1010001
10010010100001010001
100111100CC001010001
10000C10000001010001
1111101C0000C1010001
10000C11110111010001
1011111C0000C1010001
10000C10111111010001
10000C10100000000001
10111110101111111111
1C0000000000000000C1
1000111C000C11110001
1C0000000C00000000C1
11111111111111111111

Multiverse/heart.ber

MAP SOURCE : https://github.com/dariansereno/so_long/blob/master/maps/20.ber
