1111111111111111111
111111P011100111111
1C00110C10000C00111
1000C00000C0000C011
1000000011000000001
1C0000C00100C000001
1000C11001100000011
11100000C000100C111
1111111111111E11111
1111111111111111111

Multiverse/ft_end.ber

MAP SOURCE : https://github.com/miracgenc/so_long/blob/main/map/map2.ber
