1111111111111111
1000000000000001
1011110001111101
1011111111111101
1011111111111101
1011111111111101
1011111111111101
1011CCCCCCCC1101
10011CCCCCC11001
100011CCCC110001
1000011PE1100001
1000001111000001
1000000110000001
1000000000000001
1111111111111111
